[level]

level = -.#Ss



levelb  = #########################
				 #S......................#
				 #..................###..#
				 #.......................#
				 #.......#######.........#
				 #.............##........#
				 #.............#.........#
			 	 #.............#..########
				 #.............#.........#
				 ###############.........#
				 #........#....#.........#
				 #........#..#.#.........#
				 #......#.#..#.#.........#
				 #.....#..#..#.#.........#
				 #.....#.....#...........#
				 ############s############
				 

levelc = #####################
			   #s.................S#
			   #####################
				 
leveld = #####################
				 #S.................s#
				 #####################

