[level]
map = ################
			#....#.........#
			#....#.........#
			###..####......#
			#..#....#......#
			####.#..####...#
			#.#..#.....#...#
			#.#..#######...#
			#.#..#.........#
			#.#..#.........#
			#..............#
			#..............#
			#..............#
			#..............#
			#..............#
			################
		




[.]
name = floor

[#]
name = wall
wall = true

