[level]
level  = #########################
				 #s..........#...........#
				 #...........#...........#
				 #.......................#
				 #.......................#
				 #.......................#
				 #.......................#
			 	 #.......................#
				 #.......................#
				 #.......................#
				 #.......................#
				 #.......................#
				 #.......................#
				 #.......................#
				 #.......................#
				 ############S############
				 -----------###-----------

levelb  =##########
			   #.s......#
			   #.......S#
			   ##########


levelc = ###s#

