[level]
level  = #########################
				 #s......................#
				 #.......................#
				 #.......................#
				 #.......................#
				 #.......................#
				 #.......................#
			 	 #.......................#
				 #.......................#
				 #.......................#
				 #.......................#
				 #.......................#
				 #.......................#
				 #.......................#
				 #.......................#
				 ############S############
				 -----------###-----------

levelb = #####################
			   #s.................S#
			   #####################
				 
levelc = #####################
				 #S.................s#
				 #####################

