[level]
map = 			################
			#....#.........#
			#....#.......T.#
			###..####......#
			#..#....#......#
			####.#..####...#
			#.#..#.....#...#
			#.#..#######...#
			#.#..#.........#
			#.#..#.T.......#
			#..............#
			#..............#
			#T.............#
			#..............#
			#.............T#
			################
		




[.]
name = floor

[#]
name = wall
wall = true

